{
    "name": "Level 1",
    "id": "level1",
    "from": "level0",
    "to": "level2",
    "data": [   
        [   0,      0,      0,      0,      0,      0,      0,      0,      0,      0,      0,      0,      0,      0,      0,      0,      0,      0,      0,      0    ],
        [   0,      0,      0,      0,      0,      0,      0,      0,      0,      0,      0,      0,      0,      0,      0,      0,      0,      0,      0,      0    ],
        [   0,      0,      0,      0,      0,      0,      0,      0,      0,      0,      0,      0,      0,      0,      0,      0,      0,      0,      0,      0    ],
        [   0,      0,      0,      0,      0,    372,      0,      0,      0,      0,      0,    372,      0,      0,    372,      0,      0,      0,      0,      0    ],
        [   0,      0,    330,      0,      0,      0,      0,      0,    330,      0,      0,      0,      0,      0,      0,      0,      0,      0,      0,      0    ],
        [   0,      0,      0,      0,      0,      0,      0,      0,      0,      0,      0,      0,      0,      0,      0,      0,      0,      0,      0,      0    ],
        [ 372,      0,      0,      0,      0,      0,      0,      0,      0,      0,      0,      0,      0,      0,      0,      0,      0,    330,      0,      0    ],
        [   0,      0,      0,      0,      0,      0,      0,      0,      0,      0,      0,      0,      0,      0,      0,      0,      0,      0,      0,      0    ],
        [   0,      0,    362,    362,    362,      0,      0,    362,    362,    362,      0,      0,      0,      0,      0,      0,      0,      0,      0,      0    ],
        [   0,      0,      0,      0,      0,      0,      0,      0,      0,      0,      0,      0,    360,    370,      0,      0,      0,      0,      0,      0    ],
        [  -1,      0,      0,      0,      0,      0,      0,      0,      0,      0,      0,      0,    361,    371,      0,      2,      0,      2,      0,      1    ],
        [ 362,    362,    362,    362,    362,    362,    362,    362,    362,    362,    362,    362,    362,    362,    362,    362,    362,    362,    362,    362    ],
        [ 362,    362,    362,    362,    362,    362,    362,    362,    362,    362,    362,    362,    362,    362,    362,    362,    362,    362,    362,    362    ],
        [ 362,    362,    362,    362,    362,    362,    362,    362,    362,    362,    362,    362,    362,    362,    362,    362,    362,    362,    362,    362    ],
        [ 362,    362,    362,    362,    362,    362,    362,    362,    362,    362,    362,    362,    362,    362,    362,    362,    362,    362,    362,    362    ],
        [   0,      0,      0,      0,      0,      0,      0,      0,      0,      0,      0,      0,      0,      0,      0,      0,      0,      0,      0,      0    ],
        [   0,      0,      0,      0,      0,      0,      0,      0,      0,      0,      0,      0,      0,      0,      0,      0,      0,      0,      0,      0    ],
        [   0,      0,      0,      0,      0,      0,      0,      0,      0,      0,      0,      0,      0,      0,      0,      0,      0,      0,      0,      0    ],
        [   0,      0,      0,      0,      0,      0,      0,      0,      0,      0,      0,      0,      0,      0,      0,      0,      0,      0,      0,      0    ],
        [   0,      0,      0,      0,      0,      0,      0,      0,      0,      0,      0,      0,      0,      0,      0,      0,      0,      0,      0,      0    ]
    ]
}